11111111111111111111
1CCCCCCCCCCCCCCCCCC1
1CCCCCCCCECCCCCCCCC1
1CCCCCCCCCCCCCCCCCC1
111111111111111111C1
1PCCCCCCCCCCCCCCCCC1
11111111111111111111