1111111111111111
100000000C0000P1
100000E000000001
100C00000000C001
1111111111111111