1111111111111111
100000000C000001
100000E0P0001111
100C00000000C001
1111111111111111